0 0 1 2 3 4 6 6 7 0 0 0 0 0 0
0 0 0 0 0 0 0 0 0 0 0 0 0 0 0
0 0 0 0 0 0 0 0 0 0 0 0 0 0 0
0 0 0 0 0 0 0 0 0 0 0 0 0 0 0
0 0 0 0 0 0 0 0 0 0 0 0 0 0 0
0 0 0 0 6 1 1 6 0 0 0 0 0 0 0
0 0 0 0 3 5 5 2 0 0 0 0 0 0 0
0 0 0 0 3 0 0 2 0 0 0 0 0 0 0
0 0 0 0 3 4 1 3 0 0 0 0 0 0 0
0 0 0 0 0 0 0 0 0 0 0 0 0 0 0
0 0 0 0 0 0 0 0 0 0 0 0 0 0 0
0 0 0 0 0 0 0 0 0 0 0 0 0 0 0
0 0 0 0 0 0 0 0 0 0 0 5 0 0 1
0 0 0 0 0 0 0 0 0 0 0 5 0 0 0
2 0 0 0 0 0 0 0 0 0 0 0 0 1 5