5 1 0 0 0 0 0 0 0 0 0 0 0 1 5
0 1 0 0 0 0 0 0 0 0 0 0 0 1 0
0 0 1 0 0 0 0 0 0 0 0 0 1 0 0
0 0 0 1 0 0 0 0 0 0 0 1 0 0 0
0 0 0 0 1 0 0 0 0 0 1 0 0 0 0
0 0 0 0 0 1 0 0 0 1 0 0 0 0 0
0 0 0 0 0 1 2 2 1 0 0 0 0 0 0
0 0 0 0 0 2 6 6 2 0 0 0 0 0 0
0 0 0 0 0 2 7 7 2 0 0 0 0 0 0
0 0 0 0 0 1 2 2 1 1 0 0 0 0 0
0 0 0 0 1 0 0 0 0 0 1 0 0 0 0
0 0 0 1 0 0 0 0 0 0 0 1 0 0 0
0 0 1 0 0 0 0 0 0 0 0 0 1 0 0
0 1 0 0 0 0 0 0 0 0 0 0 0 1 0
5 1 0 0 0 0 0 0 0 0 0 0 0 1 0